5 10
|--------|
|.o.|..-.|
|..-|.@0.|
|o.....-.|
|--------|