6 10
|--------|
|ooo|.0..|
|........|
|oo...@|.|
|0.....|0|
|--------|