5 10
|--------|
|.o.|..-.|
|..-|.@..|
|o.....-.|
|--------|